0000000000000000000000000000000000000000000000000000000000000000000000000000000000000000000000000000000000000000000000000000000000000000000000000000000000000000000000000000000000000000000000000000000000000000000000000000000000000000000000
0000000000000000000000000000000000000000000000000000000000000000000000000000000000000000000000000000000000000000000000000000000000000000000000000000000000000000000000000000000000000000000000000000000000000000000000000000000000000000000000
00000000000000000000S0000000000000000D0000000000000000000000000000000S00000000000000000D00000000000000000000000000000000000000000000000D000000000000000000000000000000000000000000000000000000000000000000000000000000000000000000000000000000
000000000S0000000000000000000T0000000000000000000000000000S000000000000000000T000000000000000000000000000000S00000000000000000T0000000000000000000000000000S0000000000S00000000000000000D0000000000000000000S000000000000000000000000000000000
00000000000000000000000000000000000000000000000000000000000000000000000000000000000G0G0000000000000000000000000000000000000000000000000000000000000000000000000000000000000000T000000000000000000000000000000000000000000000000000000000000000
00000000000000000000000P00000000000000000000000000000000000000000000000000000000000BBBBBBBB000BBBP00000000000000P00000000000BBB0000BPPB00000000000000000000000000000000000000000000000000000000ZZ000000000000000000000000000000000000000000000
0000000000000000000000000000000000000000000000000000000000000000000000000000000000000000000000000000000000000000000000000000000000000000000000000000000000000000000000000000000000000000000000ZZZ000000000000000000000000000000000000000000000
000000000000000000000000000000000000000000000000000000000000000000000000000000000000000000000000000000000000000000000000000000000000000000000000000000000000000000000000000000000000000000000ZZZZ000000000000000000000000000000000000000000000
00000000000000000000B000G0B00000000000000000000000000000000000000000000000000000000000000000000000000000000000000000000000000000000000000000000000000000000000000000000000000000000000000000ZZZZZ000000000000000000000000000000000000000000000
00000000000000000P000BPBPB0000000000000000000000IO000000000IO000000000000000000BPB000000000000000B00000BB0000P00P00P00000B0000000000BB000000Z00Z0000000000ZZ00Z000000000000BBPB000000000000ZZZZZZ000000000000C00000000000000000000000000000000
000000000000000000000000000000000000000IO0000000KL000000000KL0000000000000000000000000000000000000X0000000000000000000000000000000000000000ZZ00ZZ00X00000ZZZ00ZZ00000000000000000000000000ZZZZZZZ00X000000000000000000000000000000000000000000
00000000000000000H00000000000IO00000000KL0000000KLX00000000KL00000H000000000000000000000000000000000000000000000000H0000000000000000000000ZZZ00ZZZ000000ZZZZ00ZZZ00000IO00000000000000IO0ZZZZZZZZ00000000F0000000000H0000000000000000000000000
0000000M0000J00000000000V00G0KL00000000KL0N00G00KL000GG0000KLJ000000000000V00000000000000000N00000G00G00000000JG00G0G000R000V0G0G0000G0G0ZZZZN0ZZZZ0000ZZZZZ00ZZZZ0000KL000V000000G0G0KLZZZZZZZZZ00000000Z000000000000000000000000000000000000
1111111111111111111111111111111111111111111111111111111111111111111111100111111111111111000111111111111111111111111111111111111111111111111111111111111111110011111111111111111111111111111111111111111111111111111111111111111111111111111111
1111111111111111111111111111111111111111111111111111111111111111111111100111111111111111000111111111111111111111111111111111111111111111111111111111111111110011111111111111111111111111111111111111111111111111111111111111111111111111111111
